.....c...s
.t.t...tcc
.t.t..s...
.t.tsc...t
.t.t.t..s.
.t.cttt...
.t...st.t.
..ctttt...
c.........
..c..t...p