....t....t
.t........
....t..t..
...t......
t.....t..t
.....p..t.
..t...t...
cccc.ccccc
..........
.s.s.s.s.s